# # ### #   #   ###
# # #   #   #   # #
### ### #   #   # #
# # #   #   #   # #
# # ### ### ### ###

###########
#  #  #   #
#  #  #
#  ####   
#     #   #
#         #
#         #
###########